NO ./wall_textures/1.xpm
SO ./wall_textures/2.xpm
WE ./wall_textures/3.xpm
EA ./wall_textures/4.xpm

F 0,51,102
C 255,255,225

        11111111111111111111111111
        10000000001100000000000001
        10000000111000000000000001
        10000000000000000000000001
1111111110000000000000000000000001
1000000000000000000000000000000001
1000000011111000000000000000000001
10000011     110000000000000000001
1000011       11000000000000000001
100011         1100000000000000001
10001           100000000000000001
10001           100000000000000001
10001           100000000000000001
100011         1100000000000000001
1000011       11000000000000000001
10000011     110000000000000000001
1000000011111000000000000000000001
10000000000000000000000W0000000001
1111111111111111111111111111111111

